...###......
..##...####
.##..###..#
##........#
#...@..#..#
###..###..#
..#..#....#
.##.##.#.##
.#......##
.#.....
.#######
..
